@.#k.#...#.
#.##.###...
.....#...#.
.##.##.###.
...........
#.#.#####d#
..#.#...#.#
.##.###.#.#
.k#.#e#....
.##.#.d.##.
....#.#....