..k#.#.#...
.###.#.#k#.
...#....##.
##..##.#...
..#..#.#.##
@#k#.d.d.de
.#.#.#.#..#
.#...#..##.
.###.##....
......#.##.