###############################
#.....#...#.........#.......#.e
#.#####.###.#.#######.#######.#
#...........#.#.....#.......d.#
#.#####.#######.###.#.#####.###
#.#.....#.......#.#.#.#.....#.#
###.#####.#######.#.###.#####.#
#.#.........#...#.#...........#
#.#.#.#.###.#.#.#.###.#######.#
#...#.#...#.#.#.#.....#.....#.#
#.#.#.#.###.#.#.###########.#.#
#.#.#.#.#.....#...#.........#.#
###.#.###########.#.#####.#.###
#...#...........#.#.....#.#...#
#.#.#.#######.#.#.#####.#.###.#
#.#.#...#...#.#.#.....#.#.#.#.#
#.#####.#.#.#.#.#####.#.###.###
#.#.....#.#.#.#.#.....#.......#
#.#.#####.#.###.#.###.#####.###
#...#...#.#...#.....#.#...#...#
###.#.#.#.###.#######.#.#.#.#.#
#.#k#.#.#.#.#.#...#...#.#.#.#.#
#.###.#.#.#.#.#.#.#.###.###.#.#
#.....#.#.#.#...#.#.#.......#.#
#.#####.#.#.#####.#.#######.###
#.#...#...#...#...#...#...#...#
#.#.#########.#.###.#.#.#.#.###
#.#.........#.#.....#.#.#.#...#
#.###.#####.#.#######.#.#.###.#
@.....#...........#.....#.....#
###############################
